111111111111111111111
1P0000000000000111111
111111000000000011111
111000000000000111111
100000000001110000111
111000000000001111111
100000000C00000111111
110000000000000000111
111110000000000001111
11111E000000000001111
111111111111111111111

