1111111111
1P00000011
1100000001
1110011111
1000000001
1111111111
