111111111111
1P0000001111
1101C1000111
100001011001
111010000011
100C10010E01
111111111111
