111111111111
1P0000001111
110111000111
100001011001
111010C00011
100110010E01
111111111111
