1111111111111
10000000C0001
1000011111P01
1000111000001
1111111111111
