1111111111111
1000000000001
1000011111P01
1000111000001
1111111111111