11111111111111111111111
1E000000001001110001111
1101C100000000000000111
10000000P00000001011001
11101000000000000011001
100C1001000000000000001
10000000000001111000111
11111111111111111111111