11111111111111111111111
1P000000001001110001111
1101C100000000000000111
10000000000000001011001
11101000000000000000011
100C10010000000000000E1
10000000000001111000111
11111111111111111111111