1111
1P01
1001
1101
1C01
10E1
1111